"","nflId","total_tackles1","total_assists","total_tackles","total_missed_tackles","missed_tackle_percentage","made_tackle_percentage"
"1",33131,8,10,18,4,0.181818181818182,0.818181818181818
"2",35449,4,4,8,1,0.111111111111111,0.888888888888889
"3",35452,6,6,12,1,0.0769230769230769,0.923076923076923
"4",35454,3,3,6,1,0.142857142857143,0.857142857142857
"5",35459,28,23,51,9,0.15,0.85
"6",35466,36,9,45,3,0.0625,0.9375
"7",35470,6,5,11,7,0.388888888888889,0.611111111111111
"8",35493,8,5,13,1,0.0714285714285714,0.928571428571429
"9",35522,2,4,6,0,0,1
"10",35562,13,9,22,1,0.0434782608695652,0.956521739130435
"11",37075,8,1,9,3,0.25,0.75
"12",37078,25,4,29,2,0.0645161290322581,0.935483870967742
"13",37084,7,4,11,1,0.0833333333333333,0.916666666666667
"14",37087,3,1,4,1,0.2,0.8
"15",37097,18,13,31,6,0.162162162162162,0.837837837837838
"16",37104,17,13,30,1,0.032258064516129,0.967741935483871
"17",37145,2,2,4,1,0.2,0.8
"18",37308,8,11,19,0,0,1
"19",37724,16,1,17,0,0,1
"20",37778,18,10,28,3,0.0967741935483871,0.903225806451613
"21",37792,0,1,1,0,0,1
"22",37841,1,2,3,1,0.25,0.75
"23",38540,27,4,31,4,0.114285714285714,0.885714285714286
"24",38542,6,10,16,1,0.0588235294117647,0.941176470588235
"25",38544,1,3,4,0,0,1
"26",38545,3,2,5,1,0.166666666666667,0.833333333333333
"27",38548,10,3,13,3,0.1875,0.8125
"28",38551,11,5,16,5,0.238095238095238,0.761904761904762
"29",38559,36,7,43,2,0.0444444444444444,0.955555555555556
"30",38577,40,23,63,1,0.015625,0.984375
"31",38588,37,23,60,1,0.0163934426229508,0.983606557377049
"32",38589,5,2,7,2,0.222222222222222,0.777777777777778
"33",38592,13,3,16,5,0.238095238095238,0.761904761904762
"34",38607,25,18,43,6,0.122448979591837,0.877551020408163
"35",38619,2,3,5,0,0,1
"36",38707,6,3,9,1,0.1,0.9
"37",38843,25,13,38,2,0.05,0.95
"38",38852,1,1,2,0,0,1
"39",38868,22,5,27,0,0,1
"40",39908,4,3,7,0,0,1
"41",39941,1,0,1,0,0,1
"42",39984,16,8,24,4,0.142857142857143,0.857142857142857
"43",39997,4,8,12,1,0.0769230769230769,0.923076923076923
"44",39998,3,6,9,1,0.1,0.9
"45",40017,27,13,40,8,0.166666666666667,0.833333333333333
"46",40030,2,6,8,0,0,1
"47",40031,5,4,9,0,0,1
"48",40039,24,12,36,6,0.142857142857143,0.857142857142857
"49",40048,3,3,6,2,0.25,0.75
"50",40074,11,12,23,1,0.0416666666666667,0.958333333333333
"51",40095,1,1,2,0,0,1
"52",40096,3,1,4,2,0.333333333333333,0.666666666666667
"53",40107,4,3,7,1,0.125,0.875
"54",40166,15,6,21,3,0.125,0.875
"55",40171,5,11,16,1,0.0588235294117647,0.941176470588235
"56",40347,10,12,22,2,0.0833333333333333,0.916666666666667
"57",40463,1,3,4,0,0,1
"58",40737,3,1,4,0,0,1
"59",41227,5,5,10,1,0.0909090909090909,0.909090909090909
"60",41231,15,5,20,3,0.130434782608696,0.869565217391304
"61",41235,18,13,31,3,0.0882352941176471,0.911764705882353
"62",41239,13,16,29,1,0.0333333333333333,0.966666666666667
"63",41240,3,0,3,1,0.25,0.75
"64",41243,55,32,87,8,0.0842105263157895,0.91578947368421
"65",41256,4,3,7,1,0.125,0.875
"66",41257,16,3,19,7,0.269230769230769,0.730769230769231
"67",41263,20,11,31,5,0.138888888888889,0.861111111111111
"68",41269,14,6,20,2,0.0909090909090909,0.909090909090909
"69",41270,16,18,34,6,0.15,0.85
"70",41279,2,0,2,0,0,1
"71",41300,34,20,54,6,0.1,0.9
"72",41336,2,10,12,2,0.142857142857143,0.857142857142857
"73",41341,8,8,16,2,0.111111111111111,0.888888888888889
"74",41358,0,1,1,0,0,1
"75",41361,0,2,2,2,0.5,0.5
"76",41363,3,6,9,2,0.181818181818182,0.818181818181818
"77",41403,5,2,7,1,0.125,0.875
"78",41464,10,9,19,4,0.173913043478261,0.826086956521739
"79",41483,18,5,23,1,0.0416666666666667,0.958333333333333
"80",41595,8,3,11,1,0.0833333333333333,0.916666666666667
"81",41599,5,9,14,4,0.222222222222222,0.777777777777778
"82",41786,3,2,5,0,0,1
"83",41915,16,11,27,2,0.0689655172413793,0.931034482758621
"84",41947,1,1,2,1,0.333333333333333,0.666666666666667
"85",42030,22,7,29,4,0.121212121212121,0.878787878787879
"86",42031,4,6,10,3,0.230769230769231,0.769230769230769
"87",42116,23,17,40,3,0.0697674418604651,0.930232558139535
"88",42331,4,8,12,4,0.25,0.75
"89",42346,8,2,10,2,0.166666666666667,0.833333333333333
"90",42349,11,7,18,0,0,1
"91",42360,3,1,4,0,0,1
"92",42361,17,6,23,6,0.206896551724138,0.793103448275862
"93",42365,2,3,5,0,0,1
"94",42368,38,28,66,9,0.12,0.88
"95",42376,1,0,1,0,0,1
"96",42378,3,1,4,0,0,1
"97",42381,15,10,25,8,0.242424242424242,0.757575757575758
"98",42388,41,24,65,10,0.133333333333333,0.866666666666667
"99",42390,21,6,27,4,0.129032258064516,0.870967741935484
"100",42391,26,12,38,7,0.155555555555556,0.844444444444444
"101",42393,12,2,14,3,0.176470588235294,0.823529411764706
"102",42395,4,4,8,4,0.333333333333333,0.666666666666667
"103",42401,13,13,26,2,0.0714285714285714,0.928571428571429
"104",42403,5,3,8,1,0.111111111111111,0.888888888888889
"105",42406,7,5,12,5,0.294117647058824,0.705882352941176
"106",42421,7,4,11,0,0,1
"107",42427,54,20,74,5,0.0632911392405063,0.936708860759494
"108",42431,20,9,29,6,0.171428571428571,0.828571428571429
"109",42433,2,3,5,2,0.285714285714286,0.714285714285714
"110",42436,6,6,12,0,0,1
"111",42441,25,7,32,9,0.219512195121951,0.780487804878049
"112",42443,7,8,15,3,0.166666666666667,0.833333333333333
"113",42444,1,3,4,2,0.333333333333333,0.666666666666667
"114",42465,11,4,15,2,0.117647058823529,0.882352941176471
"115",42467,25,16,41,4,0.0888888888888889,0.911111111111111
"116",42470,16,10,26,4,0.133333333333333,0.866666666666667
"117",42480,13,12,25,2,0.0740740740740741,0.925925925925926
"118",42485,29,12,41,5,0.108695652173913,0.891304347826087
"119",42488,28,14,42,7,0.142857142857143,0.857142857142857
"120",42512,1,1,2,0,0,1
"121",42543,26,13,39,7,0.152173913043478,0.847826086956522
"122",42553,0,1,1,1,0.5,0.5
"123",42559,2,5,7,1,0.125,0.875
"124",42560,9,8,17,1,0.0555555555555556,0.944444444444444
"125",42771,3,1,4,0,0,1
"126",42816,10,7,17,1,0.0555555555555556,0.944444444444444
"127",42826,7,5,12,1,0.0769230769230769,0.923076923076923
"128",42827,3,2,5,2,0.285714285714286,0.714285714285714
"129",42901,6,2,8,2,0.2,0.8
"130",42929,38,24,62,8,0.114285714285714,0.885714285714286
"131",42935,16,6,22,4,0.153846153846154,0.846153846153846
"132",43292,4,0,4,0,0,1
"133",43294,26,7,33,3,0.0833333333333333,0.916666666666667
"134",43296,15,18,33,1,0.0294117647058824,0.970588235294118
"135",43298,13,18,31,2,0.0606060606060606,0.939393939393939
"136",43299,14,7,21,6,0.222222222222222,0.777777777777778
"137",43301,13,8,21,4,0.16,0.84
"138",43306,25,11,36,8,0.181818181818182,0.818181818181818
"139",43308,6,3,9,2,0.181818181818182,0.818181818181818
"140",43313,13,2,15,2,0.117647058823529,0.882352941176471
"141",43316,13,18,31,1,0.03125,0.96875
"142",43321,6,4,10,0,0,1
"143",43323,15,10,25,1,0.0384615384615385,0.961538461538462
"144",43325,41,26,67,6,0.0821917808219178,0.917808219178082
"145",43326,6,4,10,1,0.0909090909090909,0.909090909090909
"146",43327,18,6,24,5,0.172413793103448,0.827586206896552
"147",43332,14,6,20,4,0.166666666666667,0.833333333333333
"148",43333,15,7,22,3,0.12,0.88
"149",43335,16,18,34,3,0.0810810810810811,0.918918918918919
"150",43338,16,11,27,2,0.0689655172413793,0.931034482758621
"151",43341,6,3,9,2,0.181818181818182,0.818181818181818
"152",43350,31,6,37,5,0.119047619047619,0.880952380952381
"153",43351,20,3,23,6,0.206896551724138,0.793103448275862
"154",43352,4,4,8,2,0.2,0.8
"155",43353,34,22,56,3,0.0508474576271186,0.949152542372881
"156",43354,6,6,12,2,0.142857142857143,0.857142857142857
"157",43356,7,5,12,0,0,1
"158",43358,6,5,11,4,0.266666666666667,0.733333333333333
"159",43361,8,3,11,0,0,1
"160",43373,25,7,32,2,0.0588235294117647,0.941176470588235
"161",43376,7,7,14,2,0.125,0.875
"162",43378,15,5,20,3,0.130434782608696,0.869565217391304
"163",43387,14,9,23,6,0.206896551724138,0.793103448275862
"164",43388,7,3,10,1,0.0909090909090909,0.909090909090909
"165",43395,5,2,7,1,0.125,0.875
"166",43404,37,26,63,9,0.125,0.875
"167",43405,8,9,17,0,0,1
"168",43407,10,7,17,4,0.19047619047619,0.80952380952381
"169",43409,8,4,12,4,0.25,0.75
"170",43411,6,12,18,4,0.181818181818182,0.818181818181818
"171",43413,3,1,4,0,0,1
"172",43420,14,6,20,2,0.0909090909090909,0.909090909090909
"173",43426,17,10,27,1,0.0357142857142857,0.964285714285714
"174",43435,8,14,22,1,0.0434782608695652,0.956521739130435
"175",43436,5,7,12,1,0.0769230769230769,0.923076923076923
"176",43441,5,13,18,4,0.181818181818182,0.818181818181818
"177",43455,7,2,9,0,0,1
"178",43478,25,9,34,9,0.209302325581395,0.790697674418605
"179",43497,28,10,38,6,0.136363636363636,0.863636363636364
"180",43503,25,26,51,9,0.15,0.85
"181",43508,3,0,3,0,0,1
"182",43522,20,5,25,3,0.107142857142857,0.892857142857143
"183",43533,21,11,32,2,0.0588235294117647,0.941176470588235
"184",43534,3,1,4,0,0,1
"185",43616,1,0,1,0,0,1
"186",43641,27,8,35,6,0.146341463414634,0.853658536585366
"187",43694,5,2,7,0,0,1
"188",43700,18,3,21,3,0.125,0.875
"189",43757,20,7,27,3,0.1,0.9
"190",43780,1,2,3,0,0,1
"191",43787,15,11,26,4,0.133333333333333,0.866666666666667
"192",43791,4,4,8,0,0,1
"193",43797,14,12,26,4,0.133333333333333,0.866666666666667
"194",43938,2,0,2,0,0,1
"195",43986,10,1,11,3,0.214285714285714,0.785714285714286
"196",44174,2,1,3,0,0,1
"197",44813,5,6,11,3,0.214285714285714,0.785714285714286
"198",44815,5,7,12,0,0,1
"199",44818,3,0,3,0,0,1
"200",44823,11,5,16,0,0,1
"201",44825,10,4,14,9,0.391304347826087,0.608695652173913
"202",44827,27,10,37,2,0.0512820512820513,0.948717948717949
"203",44828,20,10,30,4,0.117647058823529,0.882352941176471
"204",44829,17,9,26,3,0.103448275862069,0.896551724137931
"205",44830,33,8,41,7,0.145833333333333,0.854166666666667
"206",44834,8,4,12,0,0,1
"207",44837,16,11,27,1,0.0357142857142857,0.964285714285714
"208",44838,0,1,1,0,0,1
"209",44842,5,0,5,0,0,1
"210",44848,44,26,70,11,0.135802469135802,0.864197530864198
"211",44851,23,9,32,4,0.111111111111111,0.888888888888889
"212",44854,25,7,32,1,0.0303030303030303,0.96969696969697
"213",44855,3,1,4,0,0,1
"214",44861,1,0,1,0,0,1
"215",44862,12,10,22,3,0.12,0.88
"216",44863,6,3,9,1,0.1,0.9
"217",44866,10,5,15,1,0.0625,0.9375
"218",44867,4,12,16,4,0.2,0.8
"219",44869,14,8,22,3,0.12,0.88
"220",44871,7,6,13,1,0.0714285714285714,0.928571428571429
"221",44872,30,6,36,5,0.121951219512195,0.878048780487805
"222",44873,20,4,24,7,0.225806451612903,0.774193548387097
"223",44877,9,9,18,3,0.142857142857143,0.857142857142857
"224",44878,18,3,21,2,0.0869565217391304,0.91304347826087
"225",44880,3,2,5,3,0.375,0.625
"226",44886,9,9,18,1,0.0526315789473684,0.947368421052632
"227",44887,17,11,28,2,0.0666666666666667,0.933333333333333
"228",44888,37,24,61,4,0.0615384615384615,0.938461538461538
"229",44893,23,6,29,3,0.09375,0.90625
"230",44902,24,6,30,5,0.142857142857143,0.857142857142857
"231",44903,29,9,38,9,0.191489361702128,0.808510638297872
"232",44904,16,9,25,3,0.107142857142857,0.892857142857143
"233",44905,4,3,7,0,0,1
"234",44906,19,1,20,4,0.166666666666667,0.833333333333333
"235",44911,31,7,38,7,0.155555555555556,0.844444444444444
"236",44915,10,6,16,1,0.0588235294117647,0.941176470588235
"237",44922,2,1,3,1,0.25,0.75
"238",44925,45,19,64,10,0.135135135135135,0.864864864864865
"239",44926,35,17,52,16,0.235294117647059,0.764705882352941
"240",44929,3,7,10,4,0.285714285714286,0.714285714285714
"241",44937,1,2,3,1,0.25,0.75
"242",44938,11,10,21,3,0.125,0.875
"243",44944,15,12,27,2,0.0689655172413793,0.931034482758621
"244",44955,2,4,6,1,0.142857142857143,0.857142857142857
"245",44957,31,14,45,3,0.0625,0.9375
"246",44964,27,7,34,5,0.128205128205128,0.871794871794872
"247",44968,17,5,22,2,0.0833333333333333,0.916666666666667
"248",44974,7,7,14,2,0.125,0.875
"249",44976,31,6,37,6,0.13953488372093,0.86046511627907
"250",44991,12,18,30,2,0.0625,0.9375
"251",44999,37,17,54,6,0.1,0.9
"252",45004,28,20,48,3,0.0588235294117647,0.941176470588235
"253",45008,9,4,13,1,0.0714285714285714,0.928571428571429
"254",45009,7,11,18,4,0.181818181818182,0.818181818181818
"255",45011,14,7,21,3,0.125,0.875
"256",45021,10,4,14,0,0,1
"257",45033,2,3,5,0,0,1
"258",45038,12,1,13,1,0.0714285714285714,0.928571428571429
"259",45045,0,0,0,1,1,0
"260",45063,0,1,1,1,0.5,0.5
"261",45215,1,1,2,0,0,1
"262",45226,4,7,11,2,0.153846153846154,0.846153846153846
"263",45287,30,11,41,5,0.108695652173913,0.891304347826087
"264",45345,40,19,59,10,0.144927536231884,0.855072463768116
"265",45352,3,5,8,0,0,1
"266",45395,17,10,27,7,0.205882352941176,0.794117647058824
"267",45571,18,7,25,2,0.0740740740740741,0.925925925925926
"268",45643,14,10,24,6,0.2,0.8
"269",46073,18,2,20,4,0.166666666666667,0.833333333333333
"270",46074,11,11,22,6,0.214285714285714,0.785714285714286
"271",46077,50,32,82,7,0.0786516853932584,0.921348314606742
"272",46080,26,17,43,2,0.0444444444444444,0.955555555555556
"273",46081,7,13,20,1,0.0476190476190476,0.952380952380952
"274",46082,10,20,30,4,0.117647058823529,0.882352941176471
"275",46083,9,8,17,1,0.0555555555555556,0.944444444444444
"276",46085,39,23,62,5,0.0746268656716418,0.925373134328358
"277",46086,37,30,67,5,0.0694444444444444,0.930555555555556
"278",46087,18,5,23,4,0.148148148148148,0.851851851851852
"279",46088,34,25,59,3,0.0483870967741935,0.951612903225806
"280",46091,45,39,84,6,0.0666666666666667,0.933333333333333
"281",46097,19,12,31,5,0.138888888888889,0.861111111111111
"282",46098,5,6,11,2,0.153846153846154,0.846153846153846
"283",46099,12,9,21,1,0.0454545454545455,0.954545454545455
"284",46105,8,3,11,0,0,1
"285",46114,5,2,7,0,0,1
"286",46117,18,15,33,6,0.153846153846154,0.846153846153846
"287",46121,1,0,1,0,0,1
"288",46122,6,3,9,1,0.1,0.9
"289",46123,23,15,38,4,0.0952380952380952,0.904761904761905
"290",46124,28,2,30,7,0.189189189189189,0.810810810810811
"291",46127,11,6,17,5,0.227272727272727,0.772727272727273
"292",46132,30,6,36,4,0.1,0.9
"293",46133,7,5,12,2,0.142857142857143,0.857142857142857
"294",46135,13,11,24,3,0.111111111111111,0.888888888888889
"295",46137,24,11,35,9,0.204545454545455,0.795454545454545
"296",46138,14,19,33,1,0.0294117647058824,0.970588235294118
"297",46139,33,21,54,3,0.0526315789473684,0.947368421052632
"298",46141,4,7,11,3,0.214285714285714,0.785714285714286
"299",46142,35,14,49,7,0.125,0.875
"300",46144,6,8,14,3,0.176470588235294,0.823529411764706
"301",46146,20,13,33,5,0.131578947368421,0.868421052631579
"302",46148,14,3,17,2,0.105263157894737,0.894736842105263
"303",46151,9,8,17,1,0.0555555555555556,0.944444444444444
"304",46153,12,8,20,2,0.0909090909090909,0.909090909090909
"305",46156,5,2,7,1,0.125,0.875
"306",46157,5,9,14,0,0,1
"307",46159,7,5,12,3,0.2,0.8
"308",46162,7,1,8,3,0.272727272727273,0.727272727272727
"309",46164,3,1,4,0,0,1
"310",46165,9,11,20,1,0.0476190476190476,0.952380952380952
"311",46175,19,16,35,5,0.125,0.875
"312",46185,5,6,11,2,0.153846153846154,0.846153846153846
"313",46186,27,19,46,10,0.178571428571429,0.821428571428571
"314",46187,12,1,13,2,0.133333333333333,0.866666666666667
"315",46188,30,23,53,7,0.116666666666667,0.883333333333333
"316",46190,34,13,47,6,0.113207547169811,0.886792452830189
"317",46194,15,10,25,7,0.21875,0.78125
"318",46197,6,5,11,1,0.0833333333333333,0.916666666666667
"319",46199,15,6,21,5,0.192307692307692,0.807692307692308
"320",46204,9,6,15,1,0.0625,0.9375
"321",46205,6,7,13,1,0.0714285714285714,0.928571428571429
"322",46211,34,6,40,5,0.111111111111111,0.888888888888889
"323",46212,18,31,49,2,0.0392156862745098,0.96078431372549
"324",46214,5,11,16,3,0.157894736842105,0.842105263157895
"325",46215,11,2,13,0,0,1
"326",46219,1,0,1,1,0.5,0.5
"327",46223,2,2,4,2,0.333333333333333,0.666666666666667
"328",46229,7,4,11,2,0.153846153846154,0.846153846153846
"329",46232,2,4,6,2,0.25,0.75
"330",46249,9,6,15,4,0.210526315789474,0.789473684210526
"331",46253,5,4,9,3,0.25,0.75
"332",46255,2,4,6,2,0.25,0.75
"333",46259,39,12,51,4,0.0727272727272727,0.927272727272727
"334",46264,13,15,28,4,0.125,0.875
"335",46269,59,26,85,11,0.114583333333333,0.885416666666667
"336",46278,15,6,21,1,0.0454545454545455,0.954545454545455
"337",46290,3,3,6,1,0.142857142857143,0.857142857142857
"338",46304,55,28,83,12,0.126315789473684,0.873684210526316
"339",46307,16,13,29,5,0.147058823529412,0.852941176470588
"340",46312,4,4,8,3,0.272727272727273,0.727272727272727
"341",46329,2,2,4,0,0,1
"342",46354,15,4,19,5,0.208333333333333,0.791666666666667
"343",46378,0,1,1,0,0,1
"344",46387,3,6,9,2,0.181818181818182,0.818181818181818
"345",46407,2,1,3,0,0,1
"346",46456,14,11,25,9,0.264705882352941,0.735294117647059
"347",46457,0,1,1,1,0.5,0.5
"348",46487,12,4,16,1,0.0588235294117647,0.941176470588235
"349",46501,1,2,3,0,0,1
"350",46504,4,1,5,1,0.166666666666667,0.833333333333333
"351",46521,14,8,22,1,0.0434782608695652,0.956521739130435
"352",46527,33,11,44,12,0.214285714285714,0.785714285714286
"353",46543,1,4,5,0,0,1
"354",46618,1,1,2,0,0,1
"355",46630,0,1,1,0,0,1
"356",46649,1,1,2,0,0,1
"357",46652,19,8,27,3,0.1,0.9
"358",46657,9,3,12,2,0.142857142857143,0.857142857142857
"359",46669,45,19,64,7,0.0985915492957746,0.901408450704225
"360",46672,0,1,1,1,0.5,0.5
"361",46674,2,1,3,0,0,1
"362",46680,5,2,7,0,0,1
"363",46686,6,5,11,3,0.214285714285714,0.785714285714286
"364",46698,9,6,15,2,0.117647058823529,0.882352941176471
"365",46699,6,2,8,3,0.272727272727273,0.727272727272727
"366",46700,12,3,15,2,0.117647058823529,0.882352941176471
"367",46711,24,6,30,3,0.0909090909090909,0.909090909090909
"368",46729,9,1,10,1,0.0909090909090909,0.909090909090909
"369",46757,25,9,34,0,0,1
"370",46771,6,4,10,3,0.230769230769231,0.769230769230769
"371",46775,11,3,14,3,0.176470588235294,0.823529411764706
"372",46796,0,4,4,1,0.2,0.8
"373",46823,4,5,9,1,0.1,0.9
"374",46841,3,3,6,1,0.142857142857143,0.857142857142857
"375",46846,9,10,19,3,0.136363636363636,0.863636363636364
"376",46902,12,11,23,2,0.08,0.92
"377",46958,6,0,6,2,0.25,0.75
"378",47785,8,4,12,1,0.0769230769230769,0.923076923076923
"379",47786,14,10,24,2,0.0769230769230769,0.923076923076923
"380",47787,2,6,8,0,0,1
"381",47788,36,27,63,6,0.0869565217391304,0.91304347826087
"382",47790,11,9,20,4,0.166666666666667,0.833333333333333
"383",47792,4,5,9,1,0.1,0.9
"384",47793,25,18,43,1,0.0227272727272727,0.977272727272727
"385",47795,13,11,24,4,0.142857142857143,0.857142857142857
"386",47796,23,17,40,2,0.0476190476190476,0.952380952380952
"387",47799,16,15,31,7,0.184210526315789,0.815789473684211
"388",47800,12,12,24,5,0.172413793103448,0.827586206896552
"389",47802,10,12,22,5,0.185185185185185,0.814814814814815
"390",47804,23,7,30,9,0.230769230769231,0.769230769230769
"391",47809,13,11,24,1,0.04,0.96
"392",47810,36,12,48,9,0.157894736842105,0.842105263157895
"393",47811,4,3,7,3,0.3,0.7
"394",47816,29,6,35,3,0.0789473684210526,0.921052631578947
"395",47817,24,7,31,5,0.138888888888889,0.861111111111111
"396",47822,5,4,9,1,0.1,0.9
"397",47823,1,1,2,1,0.333333333333333,0.666666666666667
"398",47826,14,15,29,0,0,1
"399",47829,3,2,5,0,0,1
"400",47832,1,1,2,1,0.333333333333333,0.666666666666667
"401",47837,2,1,3,0,0,1
"402",47841,6,1,7,0,0,1
"403",47843,21,8,29,2,0.0645161290322581,0.935483870967742
"404",47844,20,18,38,3,0.0731707317073171,0.926829268292683
"405",47846,22,9,31,6,0.162162162162162,0.837837837837838
"406",47848,14,18,32,1,0.0303030303030303,0.96969696969697
"407",47854,14,11,25,4,0.137931034482759,0.862068965517241
"408",47855,26,31,57,7,0.109375,0.890625
"409",47862,10,3,13,4,0.235294117647059,0.764705882352941
"410",47863,17,17,34,1,0.0285714285714286,0.971428571428571
"411",47864,16,7,23,2,0.08,0.92
"412",47866,2,0,2,0,0,1
"413",47867,13,13,26,1,0.037037037037037,0.962962962962963
"414",47871,34,22,56,3,0.0508474576271186,0.949152542372881
"415",47872,48,23,71,4,0.0533333333333333,0.946666666666667
"416",47877,27,8,35,0,0,1
"417",47878,6,5,11,0,0,1
"418",47881,35,13,48,9,0.157894736842105,0.842105263157895
"419",47882,31,21,52,10,0.161290322580645,0.838709677419355
"420",47888,36,5,41,10,0.196078431372549,0.803921568627451
"421",47889,26,14,40,8,0.166666666666667,0.833333333333333
"422",47890,3,8,11,2,0.153846153846154,0.846153846153846
"423",47891,31,23,54,3,0.0526315789473684,0.947368421052632
"424",47899,19,3,22,2,0.0833333333333333,0.916666666666667
"425",47900,4,1,5,2,0.285714285714286,0.714285714285714
"426",47913,43,20,63,13,0.171052631578947,0.828947368421053
"427",47915,4,1,5,2,0.285714285714286,0.714285714285714
"428",47917,4,10,14,2,0.125,0.875
"429",47918,1,3,4,1,0.2,0.8
"430",47929,25,6,31,7,0.184210526315789,0.815789473684211
"431",47931,30,18,48,4,0.0769230769230769,0.923076923076923
"432",47934,9,5,14,3,0.176470588235294,0.823529411764706
"433",47938,8,12,20,5,0.2,0.8
"434",47939,13,8,21,2,0.0869565217391304,0.91304347826087
"435",47940,2,1,3,0,0,1
"436",47941,35,2,37,5,0.119047619047619,0.880952380952381
"437",47942,2,3,5,0,0,1
"438",47944,2,6,8,1,0.111111111111111,0.888888888888889
"439",47947,18,11,29,0,0,1
"440",47956,38,32,70,4,0.0540540540540541,0.945945945945946
"441",47964,11,13,24,4,0.142857142857143,0.857142857142857
"442",47971,35,26,61,9,0.128571428571429,0.871428571428571
"443",47973,12,10,22,2,0.0833333333333333,0.916666666666667
"444",47974,32,13,45,8,0.150943396226415,0.849056603773585
"445",47975,9,7,16,3,0.157894736842105,0.842105263157895
"446",47984,17,6,23,3,0.115384615384615,0.884615384615385
"447",47996,41,13,54,13,0.194029850746269,0.805970149253731
"448",48008,1,2,3,0,0,1
"449",48013,1,1,2,0,0,1
"450",48026,21,13,34,9,0.209302325581395,0.790697674418605
"451",48027,7,8,15,3,0.166666666666667,0.833333333333333
"452",48032,6,6,12,2,0.142857142857143,0.857142857142857
"453",48089,7,10,17,2,0.105263157894737,0.894736842105263
"454",48117,4,0,4,1,0.2,0.8
"455",48123,4,6,10,0,0,1
"456",48145,1,0,1,0,0,1
"457",48198,10,6,16,2,0.111111111111111,0.888888888888889
"458",48241,7,2,9,0,0,1
"459",48259,19,11,30,2,0.0625,0.9375
"460",48268,4,6,10,2,0.166666666666667,0.833333333333333
"461",48301,2,2,4,0,0,1
"462",48308,1,0,1,0,0,1
"463",48447,3,2,5,0,0,1
"464",48454,0,1,1,0,0,1
"465",48462,5,4,9,0,0,1
"466",48473,1,4,5,2,0.285714285714286,0.714285714285714
"467",48476,15,6,21,1,0.0454545454545455,0.954545454545455
"468",48482,7,4,11,1,0.0833333333333333,0.916666666666667
"469",48487,2,0,2,0,0,1
"470",48495,2,1,3,0,0,1
"471",48500,0,1,1,0,0,1
"472",48508,1,0,1,0,0,1
"473",48516,49,25,74,8,0.0975609756097561,0.902439024390244
"474",48520,3,4,7,0,0,1
"475",48537,9,6,15,0,0,1
"476",48544,12,9,21,1,0.0454545454545455,0.954545454545455
"477",48555,0,1,1,0,0,1
"478",48566,0,2,2,0,0,1
"479",48581,6,3,9,1,0.1,0.9
"480",48588,1,1,2,0,0,1
"481",48770,4,7,11,0,0,1
"482",48780,0,1,1,0,0,1
"483",49410,43,13,56,2,0.0344827586206897,0.96551724137931
"484",52272,10,3,13,2,0.133333333333333,0.866666666666667
"485",52411,38,8,46,1,0.0212765957446809,0.978723404255319
"486",52415,20,22,42,2,0.0454545454545455,0.954545454545455
"487",52416,28,12,40,6,0.130434782608696,0.869565217391304
"488",52417,27,5,32,3,0.0857142857142857,0.914285714285714
"489",52422,1,0,1,1,0.5,0.5
"490",52424,19,9,28,8,0.222222222222222,0.777777777777778
"491",52428,1,1,2,1,0.333333333333333,0.666666666666667
"492",52431,27,10,37,5,0.119047619047619,0.880952380952381
"493",52435,61,23,84,10,0.106382978723404,0.893617021276596
"494",52436,39,14,53,9,0.145161290322581,0.854838709677419
"495",52438,8,1,9,1,0.1,0.9
"496",52444,24,14,38,3,0.0731707317073171,0.926829268292683
"497",52445,16,7,23,2,0.08,0.92
"498",52446,13,15,28,1,0.0344827586206897,0.96551724137931
"499",52448,1,0,1,4,0.8,0.2
"500",52452,33,14,47,5,0.0961538461538462,0.903846153846154
"501",52453,33,4,37,1,0.0263157894736842,0.973684210526316
"502",52456,9,0,9,3,0.25,0.75
"503",52458,11,3,14,3,0.176470588235294,0.823529411764706
"504",52459,22,4,26,2,0.0714285714285714,0.928571428571429
"505",52462,1,1,2,5,0.714285714285714,0.285714285714286
"506",52464,7,12,19,1,0.05,0.95
"507",52468,6,1,7,0,0,1
"508",52469,22,11,33,9,0.214285714285714,0.785714285714286
"509",52471,15,13,28,6,0.176470588235294,0.823529411764706
"510",52472,13,6,19,5,0.208333333333333,0.791666666666667
"511",52473,35,16,51,2,0.0377358490566038,0.962264150943396
"512",52475,6,6,12,0,0,1
"513",52478,24,23,47,6,0.113207547169811,0.886792452830189
"514",52479,8,11,19,3,0.136363636363636,0.863636363636364
"515",52481,16,15,31,3,0.0882352941176471,0.911764705882353
"516",52482,1,1,2,1,0.333333333333333,0.666666666666667
"517",52490,7,3,10,1,0.0909090909090909,0.909090909090909
"518",52492,7,4,11,1,0.0833333333333333,0.916666666666667
"519",52493,5,2,7,0,0,1
"520",52495,6,7,13,1,0.0714285714285714,0.928571428571429
"521",52496,7,6,13,3,0.1875,0.8125
"522",52497,39,4,43,3,0.0652173913043478,0.934782608695652
"523",52498,4,2,6,3,0.333333333333333,0.666666666666667
"524",52505,27,16,43,6,0.122448979591837,0.877551020408163
"525",52506,15,8,23,4,0.148148148148148,0.851851851851852
"526",52510,13,10,23,2,0.08,0.92
"527",52512,8,4,12,1,0.0769230769230769,0.923076923076923
"528",52515,21,10,31,0,0,1
"529",52518,10,6,16,2,0.111111111111111,0.888888888888889
"530",52522,8,10,18,2,0.1,0.9
"531",52525,11,2,13,2,0.133333333333333,0.866666666666667
"532",52527,43,25,68,7,0.0933333333333333,0.906666666666667
"533",52535,3,3,6,0,0,1
"534",52538,5,3,8,1,0.111111111111111,0.888888888888889
"535",52539,9,2,11,2,0.153846153846154,0.846153846153846
"536",52540,0,1,1,0,0,1
"537",52542,28,19,47,6,0.113207547169811,0.886792452830189
"538",52545,3,3,6,2,0.25,0.75
"539",52546,40,14,54,6,0.1,0.9
"540",52547,10,3,13,7,0.35,0.65
"541",52563,6,7,13,1,0.0714285714285714,0.928571428571429
"542",52571,20,9,29,3,0.09375,0.90625
"543",52578,12,9,21,3,0.125,0.875
"544",52585,1,6,7,1,0.125,0.875
"545",52592,1,5,6,0,0,1
"546",52594,9,5,14,2,0.125,0.875
"547",52607,8,3,11,1,0.0833333333333333,0.916666666666667
"548",52613,10,3,13,1,0.0714285714285714,0.928571428571429
"549",52619,12,6,18,0,0,1
"550",52623,6,4,10,1,0.0909090909090909,0.909090909090909
"551",52624,32,13,45,1,0.0217391304347826,0.978260869565217
"552",52627,21,2,23,1,0.0416666666666667,0.958333333333333
"553",52637,8,8,16,2,0.111111111111111,0.888888888888889
"554",52641,3,8,11,2,0.153846153846154,0.846153846153846
"555",52647,23,5,28,7,0.2,0.8
"556",52650,0,4,4,0,0,1
"557",52651,1,0,1,0,0,1
"558",52662,4,2,6,1,0.142857142857143,0.857142857142857
"559",52663,22,14,36,11,0.234042553191489,0.765957446808511
"560",52665,3,5,8,4,0.333333333333333,0.666666666666667
"561",52697,12,1,13,1,0.0714285714285714,0.928571428571429
"562",52706,24,17,41,5,0.108695652173913,0.891304347826087
"563",52743,2,2,4,1,0.2,0.8
"564",52764,0,1,1,1,0.5,0.5
"565",52792,3,4,7,1,0.125,0.875
"566",52797,2,1,3,0,0,1
"567",52846,0,1,1,0,0,1
"568",52848,0,4,4,0,0,1
"569",52852,39,10,49,6,0.109090909090909,0.890909090909091
"570",52863,4,4,8,0,0,1
"571",52904,1,0,1,0,0,1
"572",52913,2,1,3,0,0,1
"573",52932,0,0,0,1,1,0
"574",52945,6,2,8,4,0.333333333333333,0.666666666666667
"575",52971,3,1,4,0,0,1
"576",52980,11,4,15,3,0.166666666666667,0.833333333333333
"577",52991,20,12,32,1,0.0303030303030303,0.96969696969697
"578",53050,0,3,3,0,0,1
"579",53053,1,0,1,0,0,1
"580",53059,1,0,1,0,0,1
"581",53073,7,7,14,3,0.176470588235294,0.823529411764706
"582",53437,17,9,26,5,0.161290322580645,0.838709677419355
"583",53438,20,6,26,5,0.161290322580645,0.838709677419355
"584",53441,19,9,28,2,0.0666666666666667,0.933333333333333
"585",53445,39,24,63,13,0.171052631578947,0.828947368421053
"586",53447,13,13,26,10,0.277777777777778,0.722222222222222
"587",53448,30,13,43,7,0.14,0.86
"588",53450,14,5,19,2,0.0952380952380952,0.904761904761905
"589",53451,9,1,10,3,0.230769230769231,0.769230769230769
"590",53455,17,4,21,3,0.125,0.875
"591",53457,4,4,8,0,0,1
"592",53458,20,4,24,5,0.172413793103448,0.827586206896552
"593",53459,11,3,14,2,0.125,0.875
"594",53460,16,8,24,5,0.172413793103448,0.827586206896552
"595",53461,9,9,18,4,0.181818181818182,0.818181818181818
"596",53462,31,10,41,6,0.127659574468085,0.872340425531915
"597",53465,40,9,49,5,0.0925925925925926,0.907407407407407
"598",53467,7,5,12,0,0,1
"599",53469,39,22,61,8,0.115942028985507,0.884057971014493
"600",53472,12,7,19,2,0.0952380952380952,0.904761904761905
"601",53473,0,1,1,0,0,1
"602",53476,25,3,28,4,0.125,0.875
"603",53479,1,1,2,1,0.333333333333333,0.666666666666667
"604",53481,26,14,40,8,0.166666666666667,0.833333333333333
"605",53483,4,4,8,2,0.2,0.8
"606",53487,46,23,69,2,0.028169014084507,0.971830985915493
"607",53489,51,22,73,8,0.0987654320987654,0.901234567901235
"608",53490,3,4,7,1,0.125,0.875
"609",53494,32,14,46,6,0.115384615384615,0.884615384615385
"610",53498,1,5,6,0,0,1
"611",53500,5,0,5,0,0,1
"612",53501,5,6,11,4,0.266666666666667,0.733333333333333
"613",53502,4,5,9,0,0,1
"614",53503,24,6,30,5,0.142857142857143,0.857142857142857
"615",53504,11,6,17,2,0.105263157894737,0.894736842105263
"616",53505,26,4,30,7,0.189189189189189,0.810810810810811
"617",53508,3,1,4,1,0.2,0.8
"618",53509,39,34,73,7,0.0875,0.9125
"619",53513,3,2,5,1,0.166666666666667,0.833333333333333
"620",53519,2,2,4,0,0,1
"621",53530,1,0,1,0,0,1
"622",53531,3,0,3,0,0,1
"623",53532,30,24,54,4,0.0689655172413793,0.931034482758621
"624",53533,12,3,15,2,0.117647058823529,0.882352941176471
"625",53534,6,4,10,0,0,1
"626",53535,6,8,14,1,0.0666666666666667,0.933333333333333
"627",53537,11,5,16,1,0.0588235294117647,0.941176470588235
"628",53540,5,2,7,1,0.125,0.875
"629",53542,13,10,23,4,0.148148148148148,0.851851851851852
"630",53545,0,1,1,1,0.5,0.5
"631",53547,2,3,5,2,0.285714285714286,0.714285714285714
"632",53552,2,0,2,0,0,1
"633",53554,21,13,34,2,0.0555555555555556,0.944444444444444
"634",53559,1,0,1,0,0,1
"635",53561,4,2,6,1,0.142857142857143,0.857142857142857
"636",53564,4,3,7,5,0.416666666666667,0.583333333333333
"637",53565,26,10,36,7,0.162790697674419,0.837209302325581
"638",53575,2,0,2,0,0,1
"639",53577,13,15,28,4,0.125,0.875
"640",53581,14,7,21,5,0.192307692307692,0.807692307692308
"641",53582,1,0,1,0,0,1
"642",53583,25,4,29,4,0.121212121212121,0.878787878787879
"643",53585,3,2,5,1,0.166666666666667,0.833333333333333
"644",53587,1,3,4,0,0,1
"645",53589,1,0,1,0,0,1
"646",53592,26,10,36,2,0.0526315789473684,0.947368421052632
"647",53595,13,1,14,1,0.0666666666666667,0.933333333333333
"648",53596,29,8,37,4,0.0975609756097561,0.902439024390244
"649",53599,4,4,8,2,0.2,0.8
"650",53601,15,10,25,5,0.166666666666667,0.833333333333333
"651",53602,4,9,13,4,0.235294117647059,0.764705882352941
"652",53609,28,12,40,11,0.215686274509804,0.784313725490196
"653",53611,6,10,16,7,0.304347826086957,0.695652173913043
"654",53618,5,5,10,1,0.0909090909090909,0.909090909090909
"655",53621,4,5,9,1,0.1,0.9
"656",53624,5,6,11,0,0,1
"657",53629,2,1,3,0,0,1
"658",53639,10,2,12,1,0.0769230769230769,0.923076923076923
"659",53641,38,12,50,6,0.107142857142857,0.892857142857143
"660",53642,9,4,13,4,0.235294117647059,0.764705882352941
"661",53645,0,1,1,0,0,1
"662",53649,6,2,8,1,0.111111111111111,0.888888888888889
"663",53656,8,3,11,0,0,1
"664",53661,1,1,2,0,0,1
"665",53663,2,0,2,1,0.333333333333333,0.666666666666667
"666",53668,6,4,10,1,0.0909090909090909,0.909090909090909
"667",53669,1,0,1,0,0,1
"668",53674,15,3,18,6,0.25,0.75
"669",53675,3,1,4,0,0,1
"670",53679,1,0,1,1,0.5,0.5
"671",53712,2,0,2,1,0.333333333333333,0.666666666666667
"672",53716,1,0,1,0,0,1
"673",53854,4,1,5,0,0,1
"674",53883,0,1,1,0,0,1
"675",53887,1,4,5,1,0.166666666666667,0.833333333333333
"676",53894,2,2,4,1,0.2,0.8
"677",53900,3,5,8,0,0,1
"678",53953,4,1,5,0,0,1
"679",53957,10,2,12,0,0,1
"680",54466,15,15,30,7,0.189189189189189,0.810810810810811
"681",54467,6,7,13,3,0.1875,0.8125
"682",54468,29,8,37,3,0.075,0.925
"683",54469,31,13,44,4,0.0833333333333333,0.916666666666667
"684",54470,8,4,12,2,0.142857142857143,0.857142857142857
"685",54478,9,6,15,0,0,1
"686",54479,15,6,21,3,0.125,0.875
"687",54486,2,1,3,1,0.25,0.75
"688",54487,35,22,57,5,0.0806451612903226,0.919354838709677
"689",54488,24,11,35,6,0.146341463414634,0.853658536585366
"690",54491,7,3,10,0,0,1
"691",54492,34,32,66,12,0.153846153846154,0.846153846153846
"692",54493,3,3,6,0,0,1
"693",54495,8,8,16,5,0.238095238095238,0.761904761904762
"694",54496,2,0,2,0,0,1
"695",54498,4,2,6,0,0,1
"696",54500,42,8,50,6,0.107142857142857,0.892857142857143
"697",54502,34,20,54,19,0.26027397260274,0.73972602739726
"698",54503,12,6,18,2,0.1,0.9
"699",54504,35,10,45,9,0.166666666666667,0.833333333333333
"700",54505,16,5,21,1,0.0454545454545455,0.954545454545455
"701",54511,4,3,7,0,0,1
"702",54513,37,14,51,11,0.17741935483871,0.82258064516129
"703",54514,10,2,12,6,0.333333333333333,0.666666666666667
"704",54521,6,0,6,0,0,1
"705",54523,14,13,27,6,0.181818181818182,0.818181818181818
"706",54525,9,1,10,1,0.0909090909090909,0.909090909090909
"707",54526,5,3,8,1,0.111111111111111,0.888888888888889
"708",54527,6,6,12,2,0.142857142857143,0.857142857142857
"709",54529,3,2,5,1,0.166666666666667,0.833333333333333
"710",54531,1,0,1,0,0,1
"711",54533,30,4,34,7,0.170731707317073,0.829268292682927
"712",54535,0,1,1,1,0.5,0.5
"713",54540,11,2,13,6,0.315789473684211,0.684210526315789
"714",54541,7,2,9,0,0,1
"715",54543,11,3,14,2,0.125,0.875
"716",54546,4,1,5,3,0.375,0.625
"717",54547,5,1,6,0,0,1
"718",54549,5,5,10,2,0.166666666666667,0.833333333333333
"719",54550,3,1,4,1,0.2,0.8
"720",54552,2,7,9,0,0,1
"721",54554,6,8,14,1,0.0666666666666667,0.933333333333333
"722",54560,9,9,18,4,0.181818181818182,0.818181818181818
"723",54561,7,1,8,2,0.2,0.8
"724",54562,15,10,25,3,0.107142857142857,0.892857142857143
"725",54565,1,1,2,1,0.333333333333333,0.666666666666667
"726",54567,0,2,2,2,0.5,0.5
"727",54568,5,5,10,4,0.285714285714286,0.714285714285714
"728",54573,1,4,5,1,0.166666666666667,0.833333333333333
"729",54574,29,8,37,8,0.177777777777778,0.822222222222222
"730",54578,0,1,1,0,0,1
"731",54579,12,4,16,2,0.111111111111111,0.888888888888889
"732",54580,24,3,27,7,0.205882352941176,0.794117647058824
"733",54581,0,3,3,0,0,1
"734",54582,7,7,14,0,0,1
"735",54583,7,2,9,1,0.1,0.9
"736",54584,3,2,5,2,0.285714285714286,0.714285714285714
"737",54585,0,0,0,1,1,0
"738",54586,19,5,24,7,0.225806451612903,0.774193548387097
"739",54591,2,4,6,1,0.142857142857143,0.857142857142857
"740",54600,10,3,13,3,0.1875,0.8125
"741",54606,12,8,20,3,0.130434782608696,0.869565217391304
"742",54607,0,1,1,1,0.5,0.5
"743",54611,9,4,13,2,0.133333333333333,0.866666666666667
"744",54612,2,2,4,1,0.2,0.8
"745",54615,6,2,8,2,0.2,0.8
"746",54618,23,6,29,3,0.09375,0.90625
"747",54622,8,2,10,4,0.285714285714286,0.714285714285714
"748",54624,0,0,0,1,1,0
"749",54625,12,0,12,4,0.25,0.75
"750",54632,5,2,7,3,0.3,0.7
"751",54637,3,2,5,0,0,1
"752",54639,8,2,10,1,0.0909090909090909,0.909090909090909
"753",54640,1,2,3,0,0,1
"754",54641,0,4,4,0,0,1
"755",54643,3,4,7,1,0.125,0.875
"756",54644,7,2,9,0,0,1
"757",54646,0,1,1,0,0,1
"758",54650,7,3,10,2,0.166666666666667,0.833333333333333
"759",54653,32,11,43,6,0.122448979591837,0.877551020408163
"760",54654,2,0,2,0,0,1
"761",54665,1,1,2,0,0,1
"762",54671,7,3,10,0,0,1
"763",54677,21,4,25,3,0.107142857142857,0.892857142857143
"764",54687,1,1,2,1,0.333333333333333,0.666666666666667
"765",54688,2,4,6,1,0.142857142857143,0.857142857142857
"766",54696,3,0,3,1,0.25,0.75
"767",54702,1,0,1,0,0,1
"768",54704,16,7,23,2,0.08,0.92
"769",54705,1,0,1,0,0,1
"770",54708,23,5,28,7,0.2,0.8
"771",54709,0,2,2,0,0,1
"772",54721,1,0,1,1,0.5,0.5
"773",54733,1,0,1,0,0,1
"774",54750,0,0,0,1,1,0
"775",54758,0,1,1,0,0,1
"776",54778,12,5,17,2,0.105263157894737,0.894736842105263
"777",54781,7,2,9,0,0,1
"778",54827,1,1,2,0,0,1
"779",54833,0,1,1,0,0,1
"780",54936,33,3,36,5,0.121951219512195,0.878048780487805
"781",54937,2,0,2,0,0,1
"782",54939,0,2,2,0,0,1
"783",54948,3,6,9,0,0,1
"784",54949,1,0,1,0,0,1
"785",55016,1,1,2,0,0,1
"786",55030,0,0,0,1,1,0
"787",55032,9,5,14,2,0.125,0.875
"788",55043,0,2,2,1,0.333333333333333,0.666666666666667
"789",55045,4,3,7,0,0,1
"790",55104,0,2,2,0,0,1
"791",55105,0,2,2,0,0,1
"792",55149,1,0,1,0,0,1
"793",55173,4,5,9,1,0.1,0.9
"794",55175,0,1,1,0,0,1
"795",55181,3,0,3,0,0,1
"796",55190,1,0,1,0,0,1
"797",55200,1,0,1,0,0,1
"798",55239,0,3,3,0,0,1
"799",55240,2,1,3,0,0,1
"800",55241,2,0,2,0,0,1
